#####G####
####   ###
###     ##
### ##  ##
##  ## ###
## ### ###
## ### ###
## ### ###
##       #
########S#